0001111000000000000000001
0000001111111111111111111
0000000000000000000000001
1000000000000000000000001
1000000000000000000000001
1000001111111111111111001
1001111000001000000001001
1000000000000000000001001
1000000001000001000001001
1111111111111111110001001
1000000000000000011001001
1000000000000000010001001
1111001111111111110001001
1000000000000010010011001
1000000000000010010001001
1000001111111110010001001
1000001000000010011001001
1100111000000010010001001
1000000000000010010001001
1000000000000010010011001
1000000000000010010011001
1001111000000010010001001
1001001000000010010001001
1001001111111110011001001
1001000000000000000001001
1000000000000000000001001
1000001111111110010001001
1000111100000000010001001
1000100000000000010001001
1000100000111111111111001
1000100000111111110001001
1000100000000000010001001
1000111100000000010001001
1000001111111110010001001
1000000000000000000000001
1100000000000000000000001
1111111111111111111111111